000000000000000000000000000000000000000000000000000000000
000000000000000000000000000000000000000000000000000000000
001111111111111111111111111111111111111111111111111111110
001000000000000000000000000000000000000000000000000000010
001000000000000000000000000000000000000000000000000000010
001000000000000000000000000000000000000000000000000000010
001000000000000000000000000000000000000000000000000000010
001000000000000000000000000000000000000000000000000000010
001000000000000000000000000000000000000000000000000000010
001000000000000000000000000000000000000000000000000000010
001000000000000000000000000000000000000000000000000000010
001000000000000000000000000000000000000000000000000000010
001000000000000000000000000000000000000000000000000000010
001000000000000000000000000000000000000000000000000000010
001000000000000000000000000000000000000000000000000000010
001000000000000000000000000000000000000000000000000000010
001000000000000000000000000000000000000000000000000000010
001000000000000000000000000000000000000000000000000000010
001000000000000000000000000000000000000000000000000000010
001000000000000000000000000000000000000000000000000000010
001000000000000000000000000000000000000000000000000000010
001000000000000000000000000000000000000000000000000000010
001000000000000000000000000000000000000000000000000000010
001000000000000000000000000000000000000000000000000000010
001000000000000000000000000000000000000000000000000000010
001000000000000000000000000000000000000000000000000000010
001000000000000000000000000000000000000000000000000000010
001000000000000000000000000000000000000000000000000000010
001000000000000000000000000000000000000000000000000000010
001000000000000000000000000000000000000000000000000000010
001000000000000000000000000000000000000000000000000000010
001000000000000000000000000000000000000000000000000000010
001000000000000000000000000000000000000000000000000000010
001000000000000000000000000000000000000000000000000000010
001000000000000000000000000000000000000000000000000000010
001000000000000000000000000000000000000000000000000000010
001000000000000000000000000000000000000000000000000000010
001000000000000000000000000000000000000000000000000000010
001000000000000000000000000000000000000000000000000000010
001000000000000000000000000000000000000000000000000000010
001000000000000000000000000000000000000000000000000000010
001111111111111111111111111111111111111111111111111111110
000000000000000000000000000000000000000000000000000000000